#Europaparlament
alexandra.mehnert@europarl.europa.eu	Alexandra	Mehnert	MdEe
andrea.wechsler@europarl.europa.eu	Andrea	Wechsler	MdEe
andreas.schwab@europarl.europa.eu	Andreas	Schwab	MdEr
angelika.niebler@europarl.europa.eu	Angelika	Niebler	MdEe
axel.voss@europarl.europa.eu	Axel	Voss	MdEr
bernd.lange@europarl.europa.eu	Bernd	Lange	MdEr
birgit.sippel@europarl.europa.eu	Birgit	Sippel	MdEe
christian.doleschal@europarl.europa.eu	Christian	Doleschal	MdEr
christian.ehler@europarl.europa.eu	Christian	Ehler	MdEr
christine.schneider@europarl.europa.eu	Christine	Schneider	MdEe
christine.singer@europarl.europa.eu	Christine	Singer	MdEe
daniel.caspary@europarl.europa.eu	Daniel	Caspary	MdEr
david.mcallister@europarl.europa.eu	David	Mcallister	MdEr
dennis.radtke@europarl.europa.eu	Dennis	Radtke	MdEr
engin.eroglu@europarl.europa.eu	Engin	Eroglu	MdEr
friedrich.puerner@europarl.europa.eu	Friedrich	Pürner	MdEr
gabriele.bischoff@europarl.europa.eu	Gabriele	Bischoff	MdEe
#jens.geier@europarl.europa.eu	Jens	Geier	MdEr
jens.gieseke@europarl.europa.eu	Jens	Gieseke	MdEr
joachim.streit@europarl.europa.eu	Joachim	Streit	MdEr
katarina.barley@europarl.europa.eu	Katarina	Barley	MdEe
lena.duepont@europarl.europa.eu	Lena	Düpont	MdEe
manfred.weber@europarl.europa.eu	Manfred	Weber	MdEr
manuela.ripa@europarl.europa.eu	Manuela	Ripa	MdEe
maria.noichl@europarl.europa.eu	Maria	Noichl	MdEe
marionerika.walsmann@europarl.europa.eu	Marion	Walsmann	MdEe
martin.gunther@europarl.europa.eu	Martin	Günther	MdEr
martin.schirdewan@europarl.europa.eu	Martin	Schirdewan	MdEr
#matthias.ecke@europarl.europa.eu	Matthias	Ecke	MdEr
michael.gahler@europarl.europa.eu	Michael	Gahler	MdEr
michael.vonderschulenburg@europarl.europa.eu	Michael	Vonderschulenburg	MdEr
monika.hohlmeier@europarl.europa.eu	Monika	Hohlmeier	MdEe
niclas.herbst@europarl.europa.eu	Niclas	Herbst	MdEr
norbert.lins@europarl.europa.eu	Norbert	Lins	MdEr
oezlem.demirel@europarl.europa.eu	Özlem	Demirel	MdEe
oliver.schenk@europarl.europa.eu	Oliver	Schenk	MdEr
peter.liese@europarl.europa.eu	Peter	Liese	MdEr
ralf.seekatz@europarl.europa.eu	Ralf	Seekatz	MdEr
ruth.firmenich@europarl.europa.eu	Ruth	Firmenich	MdEe
sabine.verheyen@europarl.europa.eu	Sabine	Verheyen	MdEe
stefan.berger@europarl.europa.eu	Stefan	Berger	MdEr
stefan.koehler@europarl.europa.eu	Stefan	KÃ¶hler	MdEr
sven.simon@europarl.europa.eu	Sven	Simon	MdEr
thomas.geisel@europarl.europa.eu	Thomas	Geisel	MdEr
tobias.cremer@europarl.europa.eu	Tobias	Cremer	MdEr
#udo.bullmann@europarl.europa.eu	Udo	Bullmann	MdEr
verena.mertens@europarl.europa.eu	Verena	Mertens	MdEe
vivien.costanzo@europarl.europa.eu	Vivien	Costanzo	MdEe
volker.schnurrbusch@europarl.europa.eu	Volker	Schnurrbusch	MdEr
